WE textures/west.xpm
NO  textures/north.xpm
SO  textures/south.xpm
EA  textures/east.xpm

C    78,12,12
F     255,255,125


11111111
100001
10000111
1101111
11011111111
110111110111111
10000010000001
10000010001001
1000000000101
1001110001001
1001N1000101
10010100001
10000000111
1000000101
100000011
111111111111111
