WE textures/west.xpm
NO  textures/north.xpm
SO  textures/south.xpm
EA  textures/east.xpm

C    78,12,12
F     255,255,125


11111111
1    1
1    111
1111111
    11011111111
111111111111111
100000000000001
10000000000001
1000000000001
100000000001
1000S000001
1000100001011111111111111
10000000111
1000000101
100000011
111111111111111
