C    0,12,103
SO      textures/south.xpm
EA  textures/east.xpm

F     255,255,125
NO                 textures/north.xpm


WE textures/west.xpm
           111111111111
           10000101111111111
           1111111111111
           1111011111111
           111 11 111111
   11111   101    100001
   1   1   101    101001
   1   1   1011111110101
   11111   1000010001001
           100000000101
           10010W00001
           10000000111
           100000101
           100000011
           111111111111111
           11
           111111111
           11      1 1
           11111111  111
           1000011111111
           11111111111
1